GCAGAAGTGAAGATGGCGG	UBR5-A
CGGAGCGGAGCCTGCGAGA	UBR5-B
GTGTGTCCGCGGCCCGGAG	UBR5-C
GTCCGGACTAGGGGAGGTG	UBR5-D
TCGCGGCCTAGCCTTACGG	CPQ-A
GCTCCCAGGACTAAGCTCG	CPQ-B
TGTGGCCGCCGCCACCGTA	CPQ-C
AGGCCGCGAGCTTAGTCCT	CPQ-D
TTAACCGGCACCCAGCGAG	LRRCC1-A
TAGCACTGGCGACGGGGAG	LRRCC1-B
GCCGCCGCCTCCATAGCAC	LRRCC1-C
ACGGGCGGGAAGGCATCCA	LRRCC1-D
CCGATCACTTACCACAGGC	CCNE2-A
GTGAGGAGTTGCTGCGCGT	CCNE2-B
AGCCGAGCGGTAGCTGGTC	CCNE2-C
GCCCTACCGCCGCTCGGAG	CCNE2-D
ATCAGACCTGACCCAGGGG	OXR1-A
AGGAGGTCGACGGTTTCGG	OXR1-B
CGCGCGGGAGGCGAAAGAA	OXR1-C
CGTCCAGCCCGGAGGGACC	OXR1-D
CACGGGCGAGGGGACCTGA	STK3-A
TCCCGCCGCGTCTGTCCAC	STK3-B
AGATCCGCCGCGGAGTTAC	STK3-C
CGAGCCTAGGGCACCACAG	STK3-D
AGGAGTCCACGCCTCCGGT	DSCC1-A
GCGGCGGGACTCCTAGACC	DSCC1-B
TAACTGGACGGCCCACCGG	DSCC1-C
AAGTTCCCAAGCAGCCGGA	DSCC1-D
CACGAGGGCGCCCATTCCC	RIPK2-A
GTTTGTGGTAGGGAATGGT	RIPK2-B
GCGCCCGGGACCATGAACG	RIPK2-C
ACTCCGCTGCTCGACAGGT	RIPK2-D
GAGCCCTCAAGCTCGCTCA	PHF20L1-A
CTGCGGCGCCCAGACAATA	PHF20L1-B
GCCATCCGGCCCTCCGCAG	PHF20L1-C
GGGGCCCGGCGTCGCGTCA	PHF20L1-D
GGGCTCCCGCACCCCCGGG	FAM83A-A
CAAATGGAACACACCACGG	FAM83A-B
TGCCCTGCACGCCGGTCCT	FAM83A-C
GGAGCAGGCGGCCTCCCGG	FAM83A-D
GGGCAGATAAGGGAATCAGT	GATA1-A
GCGCTCAGGAAGAGAAGCCA	GATA1-B
GTCTCCCCCAAAGCCTGATC	GATA1-C
CGGCGACAGTTCAGCCAGCA	GATA1-D
AATATGTCACATTCTGTCTC	HS2-A
GGACTATGGGAGGTCACTAA	HS2-B
GAAGGTTACACAGAACCAGA	HS2-C
GCCCTGTAAGCATCCTGCTG	HS2-D
GGAGCCAGATAAGTCAACGG	MYC-A
GTGTGTCCCACCTGATTACT	MYC-B
CTGATTACTGGGAAGTGCAA	MYC-C
AACCGAAGAACAGCTGTTGG	MYC-D
CAGGCAGTTGACAGTTAGTT	ZFPM2-A
TCTGAAGTCAGGGCTACAAC	ZFPM2-B
AAACCTGATTGATTGATGTC	ZFPM2-C
GGCTTTTGCGATAGAAGATG	ZFPM2-D
GCTGCATGGGGCGCGAATCA	NT0
GTGCACCCGGCTAGGACCGG	NT1
GTGTGCAACCTCCGCCGTTG	NT2
GCCCGAGCAGTGGCTCGCTA	NT3
GGTCAGGTAGAGGGATTGAG	NT4
GGAGGACGATCGTACTCCAG	NT5
GTATGGAGGGCTGGATCTGC	NT6
GCCTTGGCTAAACCGCTCCC	NT7
GGAGTCGGGTAAATAGACAA	NT8
GAGTGGACGACCCTGTCAGG	NT9
GTATCGGTCTGTACGGGTAG	NT10
GTGGTACGGGGCCGGCCTGT	NT11
GCAGTCGCCGCGCATCGGGC	NT12
GAGAGGTCGGATACGCTTCC	NT13
GGCCCTACATCGCTAGGCTA	NT14
GCGCCGGTTCCGTCGACTAG	NT15
GAGCAAGGTTCGGCAAAGCG	NT16
GCCAGTACTGACAGCCTTAT	NT17
GGTCGCCGTAGGGTCCGCCA	NT18
GCTAGAATGGTTGCGCGAAC	NT19
GAGCCTAACGATCGGACCGA	NT20
GCCGCTCCATCAGACTTTCT	NT21
GCTACGCCCGGGGGAAAAGA	NT22
GCAGGAGCTAAGGGTCCCGT	NT23
GTACTCCCCGAATGCAGCGG	NT24
GAGGCCGCAAACCGCGTGCG	NT25
GAGCCTCTTGGTTCCATGGA	NT26
GCTCCCCCGCTTCACTTGGG	NT27
GGTGGCCTTTGCAATTGGCG	NT28
GCGCTAGGAAACCAACAAGG	NT29
